specialpage: specialpages
identifier: identifiers
change: changes
need: needed needing
langlink: langlinks
situate: situated
eraine: eraines
pin: pinned
dominate: dominated
authority: authorities
indicator: indicators
marolle: marolles
combine: combined
beuviller: beuvillers
head: heading
chartrain: chartrains
fourche: fourches
employ: employed
trace: traces
saulce: saulces
catlink: catlinks
statement: statements
expand: expanded
accompany: accompanying
courseulle: courseulles
recentchangeslinke: recentchangeslinked
load: loaded
oyster: oysters
contribution: contributions
revier: reviers
mosle: mosles
instruction: instructions
reduce: reduced
soignolle: soignolles
aurseulle: aurseulles
settle: settled
paste: pasting
associate: associated
structure: structured
recentchange: recentchanges
diversify: diversified
maintain: maintained
landing: landings
develop: developed
hide: hidden
campagnolle: campagnolles
contribute: contributed
cormelle: cormelles
pass: passes
power: powered
landelle: landelles
plainlink: plainlinks
rocque: rocques
buisson: buissons
collapse: collapsed collapses
viller: villers
maison: maisons
statistic: statistics
exclude: excludes
place: places
vaucelle: vaucelles
maire: maires
argence: argences
extend: extended
douvre: douvres
publique: publiques
cahagnolle: cahagnolles
revision: revisions
edit: edited editing
cheese: cheeses
bague: bagues
sentence: sentences
encourage: encouraged
constitute: constitutes
vignat: vignats
fbook: fbooks
create: created
cultivate: cultivated
control: controls
log: logged
source: sources
creativecommon: creativecommons
arrondissement: arrondissements
editor: editors
exist: exists existing
auvillar: auvillars
twin: twinning twinned
rename: renamed
host: hosted
visit: visited visits
moutier: moutiers
vessel: vessels
nowraplink: nowraplinks
municipality: municipalities
feuguerolle: feuguerolles
colombelle: colombelles
terre: terres
product: products
glacier: glaciers
contain: containing
moor: moored
region: regions
bombardment: bombardments
company: companies
other: others
space: spacing
arromanche: arromanches
save: saving
complication: complications
hogue: hogues
fisherman: fishermen
microformat: microformats
departement: departements
robot: robots
colombier: colombiers
touque: touques
disclaimer: disclaimers
project: projects
grangue: grangues
vigne: vignes
caramel: caramels
dtwinne: dtwinning
croisille: croisilles
translator: translators
event: events
mouline: moulines
suble: subles
relation: relations
merge: merged
article: articles
state: states
overlay: overlays
provide: providing provided
appear: appears
lisore: lisores
vicque: vicques
retrieve: retrieved
allow: allowing
play: played
guide: guides
charle: charles
improvement: improvements
relate: related
population: populations
rebuild: rebuilt
fstatistique: fstatistiques
unsource: unsourced
sitelink: sitelinks
common: commons
southham: southhams
canton: cantons
param: params
facilitate: facilitating
translation: translations
longviller: longvillers
prefecture: prefectures
parish: parishes
include: including included
option: options
correspond: corresponding
asnelle: asnelles
stream: streams
reference: references
style: styles
rouvre: rouvres
comme: commes
mycontribution: mycontributions
vende: vendes
otherproject: otherprojects
statistique: statistiques
library: libraries
locate: located
liuhan: liuhans
inhabitant: inhabitants
early: earliest
end: ending
language: languages
content: contents
sallenelle: sallenelles
firstheade: firstheading
commander: commanders
cresseron: cresserons
register: registered
translate: translated
donate: donating
photo: photos
unpin: unpinned
water: waters
parse: parsed
select: selected
second: seconds
solier: soliers
currentevent: currentevents
enable: enabled
category: categories
commune: communes
cahagne: cahagnes
coquainvillier: coquainvilliers
fdataset: fdatasets
trigger: triggered
browse: browsing
department: departments
link: linked
large: larger
dataset: datasets
store: stores
derive: derived
caction: cactions
render: rendering
identity: identities
developer: developers
decode: decoding
marai: marais
river: rivers
position: positioned
booksource: booksources
gerrot: gerrots
subprefecture: subprefectures
moulin: moulins
high: highest
resourceloaderdynamicstyle: resourceloaderdynamicstyles
crew: crewed
start: starting
populate: populated
namespace: namespaces
call: called
copy: copying
meuvaine: meuvaines
factory: factories
error: errors
champ: champs
study: studies
espin: espins
estuary: estuaries
market: markets
loucelle: loucelles
glis: glises
foulogne: foulognes
group: groups
norolle: norolles
unporte: unported
variant: variants
maisoncelle: maisoncelles
image: images
destroy: destroyed
entity: entities
license: licenses
sailor: sailors
cache: cached
propose: proposed
villon: villons
coordinate: coordinates
conomique: conomiques
