accord: according
increase: increased increasing
specialpage: specialpages
subclass: subclasses
difference: differences
refer: referred
wearerailfan: wearerailfans
identifier: identifiers
change: changed changes
quantity: quantities
langlink: langlinks
light: lighter
obtain: obtained
consolidation: consolidations
pin: pinned
enter: entered entering
adopt: adopted
abandon: abandoned
nickname: nicknamed
authority: authorities
scrap: scrapped
firebox: fireboxes
indicator: indicators
survive: surviving survived
drawback: drawbacks
head: heading
employ: employed
catlink: catlinks
requirement: requirements
expand: expanded
articulate: articulated
recentchangeslinke: recentchangeslinked
load: loaded
park: parked
represent: represents represented
receive: received receiving
archive: archived
order: orders ordered
contribution: contributions
gere: gering
stay: stayed
spring: springs
drawing: drawings
mount: mounted
total: totalled
reduce: reduced
associate: associated
railway: railways
structure: structured
recentchange: recentchanges
advantage: advantages
schedule: scheduled
declare: declared
valve: valves
retire: retired
maintain: maintained
bring: brought
develop: developed
reprint: reprinted
hide: hidden
utilize: utilized
enhance: enhanced
power: powered
plainlink: plainlinks
couple: coupling coupled
lead: leading
small: smaller
deliver: delivered
collapse: collapsed collapses
result: resulting
nationalize: nationalized
excursion: excursions
prove: proved
renumbere: renumbered renumbering
join: joined
superheater: superheaters
statistic: statistics
enjoy: enjoyed
devote: devoted
place: placed places
compile: compiled
class: classes
extend: extended
thank: thanks
version: versions
experiment: experimented
revision: revisions
cylinder: cylinders
edit: edited editing
subclassification: subclassifications
bill: billed
sentence: sentences
encourage: encouraged
need: needed
model: models
start: started starting
supersede: superseded
uncollapse: uncollapsed
plinthe: plinthed
fbook: fbooks
create: created
control: controlled controls
log: logged
acquire: acquired
carry: carried
buy: bought
compare: comparing compared
work: worked
wheel: wheels wheeled
source: sources
creativecommon: creativecommons
assemble: assembled
wear: wearing
editor: editors
exist: exists existing
host: hosted
visit: visited
preserve: preserved
wait: waiting
commemorate: commemorating
equip: equipped
introduce: introduced
hock: hocking
nowraplink: nowraplinks
great: greater
enterprise: enterprises
make: making
harbor: harbored
become: became
establish: established
dimension: dimensions
contain: containing
big: bigger
replace: replaced replacing
run: running
frame: frames
resume: resumed
amend: amended
example: examples
fit: fitted
space: spacing
railroad: railroads
pershe: pershing
complication: complications
gradient: gradients
route: routes
form: formed
robot: robots
project: projects
disclaimer: disclaimers
recognize: recognized
evolve: evolved
produce: producing
americanrail: americanrails
variation: variations
attach: attached
disappear: disappeared
open: opened
event: events
curve: curves
recycle: recycling
stani: stanier
article: articles
restore: restored
state: states
number: numbered numbers
fpage: fpages
realise: realised
remain: remains remained
return: returned
withdraw: withdrawn
machine: machines
drop: dropped
purchase: purchased
industry: industries
retrieve: retrieved
indicate: indicates indicating
guide: guides
cheap: cheaper
charle: charles
improvement: improvements
relate: related
platform: platforms
shortage: shortages
predecessor: predecessors
benefit: benefits
rebuild: rebuilt
raise: raised
manufacturer: manufacturers
sitelink: sitelinks
await: awaiting
common: commons
service: services
speed: speeds
shortline: shortlines
consider: considered
diagram: diagrams
supply: supplied
decade: decades
describe: described
option: options
classify: classified
early: earliest earlier
frich: frichs
operate: operates operating operated
harbour: harbours
well: better
easy: easier
reference: references
style: styles
mycontribution: mycontributions
otherproject: otherprojects
trail: trailing
library: libraries
design: designs designed
reach: reached
picture: pictures
consist: consisting consisted
fwearerailfan: fwearerailfans
assign: assigned
language: languages
content: contents
firstheade: firstheading
propose: proposing
munition: munitions
register: registered
locomotive: locomotives
tender: tenders
donate: donating donated
condition: conditions
publish: publishing
column: columns
vary: varying
unpin: unpinned
parse: parsed
far: further
match: matches
select: selected
list: listed
second: seconds
currentevent: currentevents
enable: enabled
category: categories
driver: drivers
arrangement: arrangements
trigger: triggered
browse: browsing
drive: driving
modify: modified
antedate: antedates
conceive: conceived
compound: compounds
subject: subjects subjecting
link: linked
convert: converted
large: larger
loss: losses
caction: cactions
publication: publications
include: includes
follow: followed
render: rendering
launch: launched
developer: developers
decode: decoding
serve: served
intend: intended
booksource: booksources
engine: engines
haul: hauled
experience: experienced
participate: participated
high: highest
resourceloaderdynamicstyle: resourceloaderdynamicstyles
namespace: namespaces
hauler: haulers
move: moving
train: trains
steam: steaming
ringoe: ringoes
classification: classifications
enact: enacted
old: oldest
designate: designated
actuate: actuated
track: tracks
unporte: unported
variant: variants
adapt: adapted
image: images
destroy: destroyed
fleme: fleming
entity: entities
stop: stopped
license: licenses
builder: builders
undergo: undergoing
ishpeme: ishpeming
engineer: engineers
reverse: reversed
mountain: mountains
production: productions
saturate: saturated
gear: geared
cache: cached
shop: shopped
issue: issued
assimilate: assimilated
divide: divided
arrive: arrived
access: accessed
