change: changes
reynold: reynolds
travel: traveling traveled travelled
partition: partitions
gahistmarker: gahistmarkers
outfit: outfitted
requirement: requirements
expand: expanded
fill: filled
fiberglas: fiberglass
recentchangeslinke: recentchangeslinked
strawberry: strawberries
archive: archived
involve: involved
harvest: harvested
period: periods
place: placing places placed
mount: mounted
associate: associated
maintain: maintained
pineapple: pineapples
dismantle: dismantled
berry: berries
pool: pooling
seek: sought
emerge: emerged
utilize: utilized utilizing
rot: rotting
fabricate: fabricated
gain: gaining gained
require: requiring required
derailment: derailments
statistic: statistics
animal: animals
slaughter: slaughtered slaughtering
metal: metals
body: bodied bodies
distance: distances
revision: revisions
footnote: footnotes
operation: operations
need: needed
acquire: acquired
mortise: mortised
ride: riding
employ: employing employed
warehouse: warehouses
preserve: preserved
doctor: doctors
shipment: shipments
altitude: altitudes
nowraplink: nowraplinks
report: reported reports
make: making
contain: containing
drive: driving driven
connect: connecting
read: reading
specification: specifications
example: examples
cushion: cushioned
city: cities
form: formed
disclaimer: disclaimers
railcar: railcars
ducte: ducting
perishable: perishables
stre: string
onion: onions
shift: shifting
instal: installed
return: returned
standardize: standardized
vehicle: vehicles
investment: investments
retrieve: retrieved
allow: allowing allowed
commodity: commodities
common: commons
long: longer longest
include: including included includes
order: orders ordered
reach: reached reaching
reference: references
railroader: railroaders
weaken: weakened
average: averaged
design: designs designed
perforate: perforated
museum: museums
crush: crushed
language: languages
firstheade: firstheading
indicate: indicated indicating
protect: protected
implement: implemented
carton: cartons
select: selected
list: listed
currentevent: currentevents
ban: banned banning
provide: providing provided
prevent: preventing prevented
pass: passed
feature: features featuring
bruise: bruising
link: linked
publication: publications
land: landed
color: colors colored
flaw: flawed
incorporate: incorporating
high: highest higher
mushroom: mushrooms
counterpart: counterparts
customer: customers
railhead: railheads
error: errors
transport: transporting transported
postulate: postulated
feedlot: feedlots
induce: induced
house: housed houses
attempt: attempts
market: markets
barrel: barrels
hatch: hatches
cover: covered
unporte: unported
pack: packed packing
melt: melting
science: sciences
degree: degrees
circulate: circulating
discontinue: discontinued
cache: cached
issue: issued issues
invent: invented
compress: compressed
knock: knocks
innovation: innovations
prove: proved proving proven
langlink: langlinks
heater: heaters
indicator: indicators
catlink: catlinks
smoke: smoked
contribution: contributions
trailer: trailers
enter: entered
roadrail: roadrailer
restriction: restrictions
remove: removed
bizjournal: bizjournals
cause: caused
specialize: specialized
hide: hidden
location: locations
produce: produced
benefit: benefited
plainlink: plainlinks
reefer: reefers
result: resulted resulting
join: joined
handle: handled
confiscate: confiscated
boxcar: boxcars
sentence: sentences
carrot: carrots
affect: affected
log: logged
reconfigure: reconfigured
wheel: wheels wheeled
grant: granted
fail: failed
cherry: cherries
introduce: introducing introduced
army: armies
improve: improved
establish: established
company: companies
truck: trucks
determine: determined
railroad: railroads
route: routes
delivery: deliveries
come: coming
state: states
method: methods
blueberry: blueberries
dress: dressed
force: forced forces
apple: apples
replace: replaced
orange: oranges
relax: relaxed
flower: flowers
liquify: liquified
service: services
receive: received
consider: considered
bunker: bunkers
avocado: avocados
tobia: tobias
invention: inventions
refer: refers
policy: policies
pound: pounds
capture: capturing
eliminate: eliminated
salt: salting
pallet: pallets
have: having
space: spaces spacing
fumigate: fumigated
dark: darker
content: contents
parse: parsed
match: matches
second: seconds
enable: enabled
category: categories
taint: tainting
modify: modified
bottom: bottomed
consist: consisting
large: largest larger
advertisement: advertisements
fear: feared
minimise: minimised
remain: remaining remained
intend: intended
eclipse: eclipsed
bulkhead: bulkheads
alloy: alloys
grate: grates
citation: citations
call: called
train: trains
potato: potatoes
classification: classifications
invest: invested
designate: designated
block: blocks
variant: variants
entity: entities
mango: mangoes
license: licenses
cool: cooled cooling
collapse: collapsed collapses
baffle: baffles
manufacture: manufactured
pursue: pursuing
sleeper: sleepers
gallon: gallons
launch: launches launched
scrap: scrapped
producer: producers
wagon: wagons
compartment: compartments
decorate: decorated
supply: supplies supplied
culture: cultures
demand: demands
railway: railways
structure: structured
recentchange: recentchanges
retire: retired
develop: developed
think: thought
regard: regarding
announce: announced
timescale: timescales
fiber: fibers
standardise: standardised
resemble: resembled
dedicate: dedicated
ventilate: ventilated
deliver: delivered
date: dating
peak: peaked
climb: climbs
experiment: experimenting experimented
encourage: encouraged
contract: contracted
create: created
control: controlled controls
carry: carried carrying
short: shorter
editor: editors
take: taking
chill: chilled
rebuff: rebuffed
product: products
become: became
wholesaler: wholesalers
store: stored
fit: fitted fitting
cite: citing
complication: complications
insulate: insulated insulating
refrigerate: refrigerated
weigh: weighed
depend: depending
robot: robots
event: events
recommend: recommended
grow: growing
article: articles
number: numbered
slide: sliding
commence: commenced
network: networks
letter: lettering
purchase: purchased
redesignate: redesignated
guide: guides
relate: related
rebuild: rebuilt
charge: charges
raise: raised
clean: cleaned
manufacturer: manufacturers
carrier: carriers
sitelink: sitelinks
logistic: logistics
unload: unloaded unloading
operate: operating operated
foodstuff: foodstuffs
well: better
lack: lacking
fmorne: fmorning
style: styles
nectarine: nectarines
mycontribution: mycontributions
otherproject: otherprojects
early: earliest
give: giving
lease: leased
strike: strikes
communication: communications
register: registered
donate: donating
far: further
employee: employees
grower: growers
marker: markers
paint: painted
browse: browsing
caction: cactions
follow: following followed
amass: amassed
position: positioned
booksource: booksources
haul: hauling hauled
inefficiency: inefficiencies
resourceloaderdynamicstyle: resourceloaderdynamicstyles
material: materials
fgahistmarker: fgahistmarkers
namespace: namespaces
move: moving
flatcar: flatcars
provision: provisions
peach: peaches
display: displayed
assort: assorted
blanket: blanketed
segregate: segregated
access: accessed
device: devices
increase: increased
identifier: identifiers
specialpage: specialpages
vegetable: vegetables
finance: financed
inch: inches
fly: flying
pin: pinned
system: systems
head: heading
temperature: temperatures
load: loaded
crate: crates
roll: rolling
swinge: swinging
carcass: carcasses
reduce: reduced
patent: patents patented
application: applications
scallion: scallions
dugout: dugouts
pharmaceutical: pharmaceuticals
century: centuries
power: powered
facility: facilities
delay: delays
tamp: tamping
refuse: refused
tomato: tomatoes
layer: layers
edit: edited editing
offer: offered
start: started
ship: shipping shipped
hopkin: hopkins
release: released
source: sources
creativecommon: creativecommons
exist: existed exists
host: hosted
visit: visited
equip: equipped
fruit: fruits
great: greater
seem: seemed
dimension: dimensions
specialise: specialised
rely: relied
refrigerator: refrigerators
project: projects
bark: barking
enclose: enclosed
popularize: popularizes
brake: braking brakes
plain: plains
sandwich: sandwiched
drop: dropped
plant: plants
charle: charles
improvement: improvements
engrave: engraving
platform: platforms
construct: constructed
month: months
option: options
top: topped
relegate: relegated
compete: competing
retrofit: retrofitted
tend: tended
apply: applied
library: libraries
suffer: suffered
locate: located
suit: suited
shipper: shippers
picture: pictures
hopper: hoppers
extreme: extremes
publish: published publishing
column: columns
merchant: merchants
unpin: unpinned
trigger: triggered
container: containers
test: tested
derive: derived
consolidate: consolidated
appear: appeared
render: rendering
jar: jarring
latitude: latitudes
exempt: exempted
developer: developers
decode: decoding
opening: openings
rise: rising
image: images
consumer: consumers
destroy: destroyed
saving: savings
builder: builders
highland: highlands
processor: processors
technique: techniques
ration: rationing
center: centers
modification: modifications
rrpicturearchive: rrpicturearchives
accept: accepted
carsten: carstens
