specialpage: specialpages
transclusion: transclusions
change: changes
redirect: redirects
pin: pinned
indicator: indicators
head: heading
catlink: catlinks
contribution: contributions
frame: framed
pad: padded
urlencode: urlencoded
associate: associated
recentchange: recentchanges
hide: hidden
hidelink: hidelinks
clear: clearing
power: powered
require: required
collapse: collapsed collapses
statistic: statistics
place: places
class: classes
follow: following
revision: revisions
sentence: sentences
encourage: encouraged
siegfrie: siegfried
control: controls
log: logged
editor: editors
exist: exists
robot: robots
disclaimer: disclaimers
event: events
article: articles
ally: allied
retrieve: retrieved
sort: sorted
guide: guides
improvement: improvements
relate: related
service: services
edit: editing
logistic: logistics
option: options
mycontribution: mycontributions
button: buttons
language: languages
content: contents
firstheade: firstheading
donate: donating
module: modules
select: selected
currentevent: currentevents
enable: enabled
browse: browsing
widget: widgets
caction: cactions
developer: developers
bsiegfrie: bsiegfried
resourceloaderdynamicstyle: resourceloaderdynamicstyles
namespace: namespaces
variant: variants
image: images
display: displayed
