change: changes
overhang: overhanging
expand: expanded
recentchangeslinke: recentchangeslinked
archive: archives archived
associate: associated
decide: decided
statistic: statistics
exclude: excludes
jaure: jaures
revision: revisions
guillotine: guillotined
ride: riding
twin: twinning twinned
nowraplink: nowraplinks
contain: containing
resume: resumed
disclaimer: disclaimers
plage: plages
bodili: bodilis
retrieve: retrieved
director: directors
population: populations
common: commons
canton: cantons
prefecture: prefectures
low: lowest
shipowner: shipowners
reference: references
statistique: statistiques
language: languages
administrator: administrators
firstheade: firstheading
rusi: rusier
select: selected
currentevent: currentevents
guiler: guilers
laugi: laugier
fdataset: fdatasets
link: linked
identity: identities
want: wanted
high: highest
apartment: apartments
champ: champs
study: studies
house: housed houses
estuary: estuaries
unporte: unported
escape: escaped
science: sciences
cache: cached
acadian: acadians
coordinate: coordinates
langlink: langlinks
indicator: indicators
preschool: preschools
catlink: catlinks
contribution: contributions
loure: loures
average: averages
hide: hidden
plainlink: plainlinks
bury: buried
place: places
concern: concerning
tablissement: tablissements
vincenne: vincennes
sentence: sentences
log: logged
army: armies
microformat: microformats
departement: departements
guide: guides guiding
student: students
state: states
force: forces
fstatistique: fstatistiques
service: services
visitor: visitors
param: params
surf: surfing
inhabitant: inhabitants
found: founded
content: contents
attend: attended
advance: advanced
wind: winding
parse: parsed
second: seconds
enable: enabled
category: categories
commune: communes
department: departments
dataset: datasets
call: called
choose: chosen
old: oldest
discovery: discoveries
variant: variants
derive: derives
mende: mendes
fnormale: fnormales
entity: entities
license: licenses
collapse: collapsed collapses
conomique: conomiques
consulate: consulates
tragedy: tragedies
swim: swimming
launch: launches launched
tag: tagged
authority: authorities
village: villages
sculpture: sculptures
ibtime: ibtimes
structure: structured
recentchange: recentchanges
lycee: lycees
wet: wettest
maire: maires
school: schools
publique: publiques
vieille: vieilles
bowl: bowling
encourage: encouraged
cold: coldest
create: created
control: controls
editor: editors
clohar: clohars
jacobin: jacobins
region: regions
public: publics
space: spacing
complication: complications
robot: robots
buggye: buggying
event: events
stone: stones
relation: relations
article: articles
overlay: overlays
charrue: charrues
personality: personalities
relate: related
sitelink: sitelinks
cobble: cobbled
truromorlaixtwinne: truromorlaixtwinning
include: including
activity: activities
style: styles
mycontribution: mycontributions
otherproject: otherprojects
reach: reaches
register: registered
donate: donating
photo: photos
financier: financiers
letter: letters
imprison: imprisoned
browse: browsing
prive: prives
caction: cactions
distinguish: distinguished
resourceloaderdynamicstyle: resourceloaderdynamicstyles
namespace: namespaces
monpazi: monpazier
group: groups
etablissement: etablissements
child: children
record: recorded records
college: colleges
calvary: calvaries
enthusiast: enthusiasts
access: accessed
identifier: identifiers
specialpage: specialpages
inch: inches
feature: features
fly: flying
pin: pinned
head: heading
trace: traces
temperature: temperatures
reuter: reuters
load: loaded
jaune: jaunes
reduce: reduced
amour: amours
power: powered
edit: edited editing
offer: offered
start: started
brennili: brennilis
source: sources
creativecommon: creativecommons
arrondissement: arrondissements
braspart: brasparts
exist: exists
host: hosted
visit: visited
glacier: glaciers
street: streets
save: saving
project: projects
merge: merged
charle: charles
improvement: improvements
construct: constructed
command: commanding
option: options
frenchpropertylink: frenchpropertylinks
library: libraries
harbor: harboring
locate: located
extreme: extremes
column: columns
merchant: merchants
unpin: unpinned
grandparent: grandparents
meilar: meilars
sport: sports
trigger: triggered
render: rendering
developer: developers
decode: decoding
serve: served
subprefecture: subprefectures
mayor: mayors
normale: normales
image: images
capture: captured
