accord: according
identifier: identifiers
specialpage: specialpages
erupt: erupts
change: changes
inch: inches
need: needed needing
langlink: langlinks
courcouronne: courcouronnes
relative: relatives
pin: pinned
soindre: soindres
assault: assaulted
indicator: indicators
preschool: preschools
head: heading
village: villages
statement: statements
reuter: reuters
catlink: catlinks
expand: expanded
inspire: inspired
accompany: accompanying
recentchangeslinke: recentchangeslinked
load: loaded
colombe: colombes
landmark: landmarks
garge: garges
contribution: contributions
islamist: islamists
illier: illiers
instruction: instructions
reduce: reduced
paste: pasting
associate: associated
structure: structured
recentchange: recentchanges
longvillier: longvilliers
state: stated
borde: bordes
hide: hidden
nytime: nytimes
power: powered
plainlink: plainlinks
collapse: collapsed collapses
join: joined
maison: maisons
statistic: statistics
exclude: excludes
place: places
maire: maires
ftrappe: ftrappes
voisin: voisins
school: schools
publique: publiques
revision: revisions
rieure: rieures
vincenne: vincennes
edit: edited editing
louvecienne: louveciennes
spark: sparks
sentence: sentences
george: georges
encourage: encouraged
sarcelle: sarcelles
bazoche: bazoches
control: controls
log: logged
carry: carried
source: sources
creativecommon: creativecommons
arrondissement: arrondissements
maternelle: maternelles
editor: editors
exist: exists existing
jouar: jouars
twin: twinned
host: hosted
visit: visited
bonnelle: bonnelles
nowraplink: nowraplinks
municipality: municipalities
orvillier: orvilliers
glacier: glaciers
contain: containing
region: regions
gennevillier: gennevilliers
other: others
space: spacing
complication: complications
save: saving
city: cities
microformat: microformats
departement: departements
library: libraries
official: officials
bezon: bezons
robot: robots
disclaimer: disclaimers
project: projects
vigne: vignes
count: counting
alluet: alluets
translator: translators
suresne: suresnes
essonne: essonnes
event: events
conflan: conflans
article: articles
overlay: overlays
provide: providing provided
appear: appears
retrieve: retrieved
jumelage: jumelages
vanve: vanves
guide: guides
attack: attacks attacked
improvement: improvements
relate: related
population: populations
fstatistique: fstatistiques
unsource: unsourced
sitelink: sitelinks
common: commons
mantis: mantes
canton: cantons
param: params
translation: translations
prefecture: prefectures
option: options
fresne: fresnes
correspond: corresponding
aubervillier: aubervilliers
reference: references
style: styles
mycontribution: mycontributions
otherproject: otherprojects
statistique: statistiques
cormeille: cormeilles
issue: issues
have: having
boisset: boissets
locate: located
juzier: juziers
vanne: vannes
houille: houilles
language: languages
content: contents
firstheade: firstheading
register: registered
advance: advanced
translate: translated
donate: donating
photo: photos
villenne: villennes
column: columns
unpin: unpinned
parse: parsed
boinvillier: boinvilliers
select: selected
viaire: viaires
second: seconds
currentevent: currentevents
norme: normes
enable: enabled
category: categories
stain: stains
commune: communes
trigger: triggered
fdataset: fdatasets
browse: browsing
mentaire: mentaires
department: departments
link: linked
feucherolle: feucherolles
dataset: datasets
record: records
caction: cactions
suspect: suspected
render: rendering
atrappe: atrappes
identity: identities
chelle: chelles
developer: developers
trappe: trappes
decode: decoding
serve: served
university: universities
suburb: suburbs
subprefecture: subprefectures
high: highest
resourceloaderdynamicstyle: resourceloaderdynamicstyles
yveline: yvelines
start: starting
namespace: namespaces
copy: copying
tampe: tampes
guerne: guernes
cover: covering
kill: killed
error: errors
champ: champs
study: studies
estuary: estuaries
normale: normales
essart: essarts
group: groups
veil: veiled
claim: claimed
variant: variants
unporte: unported
image: images
fnormale: fnormales
science: sciences
entity: entities
license: licenses
climatique: climatiques
college: colleges
professionnelle: professionnelles
cache: cached
morainvillier: morainvilliers
coordinate: coordinates
conomique: conomiques
villier: villiers
