accord: according
show: showing
manufacture: manufactured
advertise: advertised
specialpage: specialpages
identifier: identifiers
piece: pieces
change: changes
result: results resulted
factor: factors
underlie: underlying
comment: commented
discover: discovers discovered
mosaic: mosaics
inch: inches
feature: features
langlink: langlinks
dry: drying
suggest: suggests
stamp: stamped
pin: pinned
break: breaking breaks broken
authority: authorities
freeze: freezing
puncture: punctures
support: supported supporting
indicator: indicators
asset: assets
system: systems
damage: damaged
proceeding: proceedings
head: heading
employ: employs employed
drain: draining
catlink: catlinks
rubberize: rubberized
expand: expanded
inspire: inspired
monitor: monitoring
dirtroadpothole: dirtroadpotholes
level: levels
fill: filled filling
load: loaded
recentchangeslinke: recentchangeslinked
sink: sunken
citizen: citizens
manifestation: manifestations
artery: arteries
agency: agencies
archive: archived
fharper: fharpers
repair: repairs repairing repaired
activist: activists
contribution: contributions
roller: rollers
patch: patched patching patches
weaken: weakens weakening weakened
period: periods
place: placing places placed
reduce: reduced
apply: applied applies
spray: spraying
get: getting
prevent: preventing prevents
associate: associated
structure: structures structured
recentchange: recentchanges
remove: removing removed
standard: standards
process: processes
cause: caused causes
specialize: specialized
state: states stated
hide: hidden
fasset: fassets
produce: produced
jurisdiction: jurisdictions
manage: managed managing
power: powered
plainlink: plainlinks
lead: leading
small: smaller
portrait: portraits
collapse: collapsed collapses
politician: politicians
prove: proved
manual: manuals
consist: consists
vary: varies
statistic: statistics
blow: blowing
casing: casings
proclaim: proclaimed
ffile: ffiles
follow: following
layer: layers
last: lasting
revision: revisions
edit: edited editing
pothole: potholes
pluck: plucked
sentence: sentences
crack: cracking cracks
encourage: encouraged
affect: affected
provide: provides providing
calm: calming
pave: paving
overlap: overlapping
control: controlled controls
log: logged
retrace: retraces
localize: localized
suspension: suspensions
depict: depicting
creativecommon: creativecommons
editor: editors
elevate: elevated
exist: exists existing
utility: utilities
saturate: saturating
eject: ejects
host: hosted
practice: practices
visit: visited
fail: failed
accident: accidents
wait: waiting
report: reporting reported
crown: crowns
nowraplink: nowraplinks
great: greater
make: making
heave: heaving
improve: improved
deprive: deprived
contain: containing
fatigue: fatigues
region: regions
surround: surrounding
run: running
portion: portions
street: streets
mouth: mouths
highway: highways
defect: defects
specification: specifications
achieve: achieving
admit: admits
determine: determined
death: deaths
space: spacing
complication: complications
fix: fixing
city: cities
beatle: beatles
symon: symons
fpothole: fpotholes
mark: marking
official: officials
depend: depending
robot: robots
pavement: pavements
penis: penises
project: projects
junction: junctions
interchange: interchanges
understand: understanding
climb: climbing
sewer: sewers
mill: milling
disclaimer: disclaimers
dot: dotted
event: events
avoid: avoiding
invent: inventing
recycle: recycling
isolate: isolated
article: articles
method: methods
number: numbered
fpublication: fpublications
depth: depths
researcher: researchers
diverge: diverging
mock: mocked
vehicle: vehicles
artist: artists
minute: minutes
plant: plants
aquaplane: aquaplaning
freporte: freporting
retrieve: retrieved
guide: guides
pass: passing
improvement: improvements
relate: related
upload: uploads
continue: continued
wheel: wheels
raise: raised
sitelink: sitelinks
common: commons
force: forced
ratchet: ratcheting
speed: speeds
reinforce: reinforced
reappear: reappearing
ditch: ditching
intersection: intersections
compare: compared
include: including includes
option: options
diminish: diminishes
maintain: maintaining
verse: verses
bleed: bleeding
reference: references
style: styles
casting: castings
mycontribution: mycontributions
otherproject: otherprojects
claim: claiming
library: libraries
suffer: suffered
allow: allows
promote: promoting
website: websites
harper: harpers
crush: crushed
language: languages
content: contents
estimate: estimated
firstheade: firstheading
activate: activated
register: registered
trench: trenches
return: returns
protect: protected
donate: donating
condition: conditions
injure: injured
column: columns
unpin: unpinned
parse: parsed
far: further
survey: surveys surveying
select: selected
straighten: straightening
compact: compacted compacting
can: cannot
second: seconds
procedure: procedures
permit: permitting
currentevent: currentevents
handbook: handbooks
distress: distresses
enable: enabled
category: categories
separate: separated
driver: drivers
paint: painted
trigger: triggered
browse: browsing
complicate: complicating
drive: driving
chunk: chunks
test: tested
pack: packed
subject: subjects
link: linked
hazard: hazards
large: larger
surface: surfaced surfaces
caction: cactions
publication: publications
expressway: expressways
track: tracking
render: rendering
engender: engendered
live: living
developer: developers
decode: decoding
unseal: unsealed
jump: jumped
fmanual: fmanuals
high: highest
fupload: fuploads
resourceloaderdynamicstyle: resourceloaderdynamicstyles
opening: openings
seal: sealing
material: materials
namespace: namespaces
motor: motoring
caricature: caricatures
cover: covering
kill: killed
error: errors
washboarde: washboarding
involve: involving
microwave: microwaves
citerefsymon: citerefsymons
spend: spends
unmaintaine: unmaintained
fpavement: fpavements
grind: grinding
unporte: unported
share: shared
variant: variants
image: images
reserve: reserved
thaw: thawing
entity: entities
license: licenses
sponsor: sponsored
reconstruct: reconstructing
technique: techniques
cross: crossing
engineer: engineers
cache: cached
accelerate: accelerates
require: requires
heat: heated
coordinate: coordinates
divide: divided
failure: failures
offer: offers
fcitie: fcities
