transloade: transloading transloaded
identifier: identifiers
specialpage: specialpages
change: changes
need: needed needing
langlink: langlinks
pin: pinned
dock: docking
destine: destined
exchange: exchanged
indicator: indicators
combine: combined
head: heading
travel: travels
beginner: beginners
employ: employed
catlink: catlinks
expand: expanded
load: loaded
recentchangeslinke: recentchangeslinked
differ: differing
archive: archived
contribution: contributions
route: routing
expedite: expedited
reduce: reduced
newspaper: newspapers
associate: associated
structure: structured
recentchange: recentchanges
teamster: teamsters
bogie: bogies
remove: removed
address: addressing
specialize: specialized
add: adding
hide: hidden
century: centuries
stevedore: stevedores
cause: causes
power: powered
plainlink: plainlinks
require: required requires
facility: facilities
collapse: collapsed collapses
limit: limits
statistic: statistics
confuse: confused
place: places
concept: concepts
handle: handling handled
revision: revisions
edit: edited editing
booking: bookings
sentence: sentences
encourage: encouraged
ship: shipping shipped
control: controls
log: logged
leave: leaves leaving
source: sources
creativecommon: creativecommons
editor: editors
exist: exists
originate: originates
specify: specified
warehouse: warehouses
host: hosted
visit: visited
transfer: transferring transferred
barge: barges
shipment: shipments
nowraplink: nowraplinks
mechanic: mechanics
contain: containing
reference: references referencing
space: spacing
complication: complications
robot: robots
disclaimer: disclaimers
chain: chains
event: events
article: articles
fpage: fpages
standardize: standardized
retrieve: retrieved
siding: sidings
guide: guides
improvement: improvements
relate: related
conveyor: conveyors
platform: platforms
unsource: unsourced
attachment: attachments
carrier: carriers
solution: solutions
sitelink: sitelinks
common: commons
service: services
convey: conveyed
fcustomer: fcustomers
concern: concerns
consider: considered
dumper: dumpers
unload: unloading
option: options
crane: cranes
include: including
ftransloade: ftransloading
style: styles
mycontribution: mycontributions
fattachment: fattachments
library: libraries
fnorthfieldme: fnorthfieldmed
capacity: capacities
float: floating
language: languages
content: contents
firstheade: firstheading
register: registered
challenge: challenged
donate: donating
unpin: unpinned
parse: parsed
transship: transshipped
expert: experts
select: selected
can: cannot
second: seconds
currentevent: currentevents
enable: enabled
accomplish: accomplished
category: categories
provide: provided
driver: drivers
station: stations
automobile: automobiles
trigger: triggered
browse: browsing
container: containers
link: linked
optimize: optimized
caction: cactions
render: rendering
northfieldme: northfieldmed
design: designed
developer: developers
decode: decoding
discussion: discussions
high: highest higher
citation: citations
resourceloaderdynamicstyle: resourceloaderdynamicstyles
minimize: minimizing
namespace: namespaces
codify: codified
sideloade: sideloading
point: points
customer: customers
atransloade: atransloading
unporte: unported
variant: variants
image: images
entity: entities
interest: interests
license: licenses
download: downloading
cache: cached
loader: loaders
elevator: elevators
arrive: arrived
