specialpage: specialpages
route: routed
change: changes
langlink: langlinks
german: germans
pin: pinned
complete: completed
throw: thrown
abandon: abandoned
ensure: ensured
become: becoming became
withdraw: withdrew
support: supporting
indicator: indicators
privateer: privateers
damage: damaged
head: heading
lease: leases
catlink: catlinks
expand: expanded
specialize: specializing specializes
fill: filled
prefer: preferred
surrender: surrendered surrendering
recentchangeslinke: recentchangeslinked
sink: sunken sinking
load: loaded
worker: workers
storm: storms
archive: archived
contribution: contributions
supply: supplies
fortress: fortresses
delay: delaying
reduce: reduced
interrupt: interrupted
occupy: occupied occupies
associate: associated
structure: structures structured
recentchange: recentchanges
long: longer
declare: declared
develop: developed
cause: caused
seek: sought
inaugurate: inaugurated
hide: hidden
warship: warships
decide: decided
clear: clearing
power: powered
plainlink: plainlinks
collapse: collapsed collapses
bomb: bombed
award: awarded
advance: advancing
statistic: statistics
place: places
meter: meters
quote: quoted
encircle: encircled
revision: revisions
edit: edited editing
submarine: submarines
sentence: sentences
encourage: encouraged
suggest: suggested
create: created
control: controls
log: logged
carry: carried carrying
pierre: pierres
creativecommon: creativecommons
editor: editors
exist: exists
salvage: salvaging
rename: renamed
host: hosted
visit: visited
weight: weighted
vessel: vessels
ally: allied allies
contain: containing
decline: declining
connect: connecting
company: companies
resume: resumed
building: buildings
complication: complications
soldier: soldiers
robot: robots
disclaimer: disclaimers
block: blocking
project: projects
open: opened
event: events
battery: batteries
recommend: recommended
stone: stones
article: articles
state: states
fortify: fortified
proposal: proposals
return: returned
force: forces
command: commands
replace: replaced
retrieve: retrieved
allow: allowing
guide: guides
charle: charles
attack: attacks
pass: passing
improvement: improvements
relate: related
tugboat: tugboats
continue: continued
sitelink: sitelinks
common: commons
service: services
revive: revived
pluvi: pluvier
param: params
option: options
crane: cranes
compose: composed
include: included
order: orders
operate: operated
access: accesses
reference: references
mycontribution: mycontributions
otherproject: otherprojects
resist: resisted
torpedo: torpedoed
fight: fighting
liberate: liberated
affaire: affaires
porte: portes
assign: assigned
language: languages
content: contents
firstheade: firstheading
register: registered
troop: troops
protect: protected
donate: donating
photo: photos
charter: chartered
unpin: unpinned
toise: toises
parse: parsed
far: further
match: matches
select: selected
employee: employees
second: seconds
installation: installations
currentevent: currentevents
america: americas
enable: enabled
category: categories
land: landing landed
basin: basins
trigger: triggered
browse: browsing
favour: favoured
quadruple: quadrupling
department: departments
link: linked
caction: cactions
appear: appeared
strong: strongest
render: rendering
large: largest
developer: developers
decode: decoding
actualite: actualites
hectare: hectares
high: highest
resourceloaderdynamicstyle: resourceloaderdynamicstyles
repair: repairs
present: presented
namespace: namespaces
call: called
timent: timents
monitor: monitors
kill: killed
franc: francs
dredge: dredging
conduct: conducted
miss: missing
unporte: unported
variant: variants
image: images
destroy: destroyed
entity: entities
license: licenses
bridge: bridges
plan: planned
travel: travelling
discontinue: discontinued
cache: cached
propose: proposed
enlarge: enlarged
list: listes
coordinate: coordinates
arrive: arrived
