accord: according
duplicate: duplicated
refer: referred
complicate: complicated
difference: differences
piece: pieces
change: changes changing
obtain: obtained
german: germans
roll: rolled rolling
adopt: adopted
abandon: abandoned
rifle: rifles
dock: docked
stall: stalled
requirement: requirements
expand: expanded
coupling: couplings
level: levels
fill: filled filling
recentchangeslinke: recentchangeslinked
archive: archived
repair: repairs repairing repaired
involve: involved
transporter: transporters
overload: overloading
credit: credited
rehabilitate: rehabilitated
stockpile: stockpiles stockpiled
associate: associated
schedule: scheduled
campaign: campaigns
discard: discarded
maintain: maintained
district: districts
channel: channeling
embark: embarked
staff: staffs
degrade: degraded
general: generals
require: required
lead: leading
empty: empties
juncture: junctures
effort: efforts
award: awarded
hand: handed
border: bordered
statistic: statistics
animal: animals
distance: distances
revision: revisions
consequence: consequences
cratere: cratered
fitting: fittings
operation: operations
need: needed
operator: operators
fbook: fbooks
work: worked working
receipt: receipts
barge: barges
shoulder: shoulders
lighter: lighters
launcher: launchers
contain: containing
drive: driven
mortar: mortars
confirm: confirmed
run: running
stage: stages
engage: engaged
instance: instances
form: formed
minesweeper: minesweepers
disclaimer: disclaimers
understand: understanding
limit: limits limiting
authorize: authorized
attach: attached
demolition: demolitions
prescribe: prescribed
open: opened
instal: installed
coutance: coutances
conflan: conflans
battery: batteries
duty: duties
return: returning returned
vehicle: vehicles
retrieve: retrieved
allow: allowing
play: played
await: awaiting
common: commons
displace: displaced
rush: rushing
suppose: supposed
regroup: regrouping
defend: defended
battalion: battalions
regiment: regiments
include: including included
order: orders ordered
prisoner: prisoners
man: manning manned
reach: reached reaching
hodge: hodges
request: requested requests
reference: references
casting: castings
average: averaged
fight: fighting
consist: consisted
language: languages
firstheade: firstheading
commander: commanders
locomotive: locomotives
troop: troops
heavy: heavier
fighter: fighters
cross: crossed
water: waters
select: selected
obstacle: obstacles
override: overriding
procedure: procedures
permit: permitted permitting
currentevent: currentevents
transmission: transmissions
provide: provided
station: stations
clutter: cluttered
shortcoming: shortcomings
opportunity: opportunities
consume: consumed
link: linked
loss: losses
batignolle: batignolles
requisition: requisitions requisitioning
recover: recovered
brown: browning
appropriate: appropriated
avranche: avranches
want: wanted
high: highest
ignore: ignoring
press: pressed
imperative: imperatives
detail: detailed
kill: killed
railhead: railheads
disapprove: disapproved
respond: responding
look: looked looking
study: studied studies
miss: missing
cover: covered
unporte: unported
restrict: restricted
discharge: discharges discharged
slow: slower
cache: cached
issue: issued
element: elements
undertake: undertaken
prove: proving proved
beach: beaches
langlink: langlinks
encase: encased
break: breaking breaks broken
decant: decanted decanting
dislike: disliked
support: supported supporting
indicator: indicators
collect: collecting collected
reduce: reducing reduced
catlink: catlinks
difficulty: difficulties
overtake: overtaking
prefer: preferred
worker: workers
contribution: contributions
trailer: trailers
tonnage: tonnages
problem: problems
enter: entered
point: points pointed
get: getting
torpedo: torpedoes
believe: believed
remove: removed
landing: landings
cause: caused
specialize: specialized
halt: halted
block: blocked
hide: hidden
approve: approved
produce: produced
contribute: contributed
result: resulted resulting
depot: depots
supply: supplying supplies supplied
package: packaged
place: placed places
affair: affairs
copy: copied
handle: handling handles handled
proceed: proceeded
effect: effected effects
sentence: sentences
affect: affected
exclude: excluding
requestion: requestions
log: logged
strike: struck
vessel: vessels
weapon: weapons
deliver: delivering delivered
command: commanded
army: armies
establish: established
company: companies
truck: trucks
determine: determined
route: routes
limitation: limitations
delivery: deliveries
hoard: hoarding
consideration: considerations
create: creating created
come: coming
state: states
exploit: exploited
entrance: entrances
ally: allied allies
withdraw: withdrawn
force: forced forces
minute: minutes
replace: replaced
hutte: hutted
shortage: shortages
service: services
receive: received
consider: considered
tractor: tractors
target: targets
pound: pounds
capture: capturing captured
define: defined
specialist: specialists
exhaust: exhausted
plan: planned planning
content: contents
unrecorde: unrecorded
attend: attended
advance: advancing advanced
flange: flanged
erect: erected
parse: parsed
challenge: challenges
match: matches
appeal: appeals
second: seconds
enable: enabled
urge: urging
light: lighter lights
category: categories
driver: drivers
cargo: cargoes
arrangement: arrangements
deadline: deadlined
airfield: airfields
modify: modified
diver: divers
large: largest larger
expect: expected
number: numbers
pipeline: pipelines
hotel: hotels
remain: remained
intend: intended
outmanoeuvere: outmanoeuvered
logistician: logisticians
focus: focused
navigate: navigated
barter: bartering
waterway: waterways
call: called
train: trains trained
regard: regarded
facilitate: facilitated
direct: directed
pick: picked
fixate: fixated
variant: variants
warn: warned
entity: entities
license: licenses
threaten: threatened
inform: informed
ferry: ferries
collapse: collapsed collapses
occur: occurred
manufacture: manufactured
gallon: gallons
decision: decisions
third: thirds
complete: completed
destine: destined
impress: impressed
asset: assets
producer: producers
downgrade: downgraded
sink: sunken
compound: compounded
truckhead: truckheads
trawler: trawlers
berth: berths berthed
anticipate: anticipated
demand: demands
subordinate: subordinated
railway: railways
structure: structured
recentchange: recentchanges
long: longer
develop: developed
bring: bringing brought
disuse: disused
soisson: soissons
turn: turned
lubricant: lubricants
pass: passes
cannibalize: cannibalizing
achievement: achievements
small: smaller
peak: peaked
hospital: hospitals
airbase: airbases
supplement: supplemented
delay: delayed delays
feature: featured
encourage: encouraged
boundary: boundaries
burn: burning
control: controlled controls
carry: carried carrying
short: shorter
hamper: hampered
fall: fallen
disadvantage: disadvantages
approach: approaches
editor: editors
take: taking
section: sections
become: became
assume: assumed
sympathizer: sympathizers
gruele: grueling
exacerbate: exacerbated
officer: officers
marshal: marshaling
fit: fitted
complication: complications
deactivate: deactivated
weigh: weighed
demolish: demolished
forecast: forecasts
robot: robots
forging: forgings
event: events
recommend: recommended
isolate: isolated
article: articles
strand: stranded
planner: planners
commence: commenced
seatrain: seatrains
redesignate: redesignated
guide: guides
relate: related
continue: continued
rebuild: rebuilt
clean: cleaned
raise: raised
carrier: carriers
solution: solutions
sitelink: sitelinks
ardenne: ardennes
hundred: hundreds
transfer: transferred
logistic: logistics
unload: unloaded unloading
roger: rogers
crane: cranes
correspond: corresponding
early: earlier
tail: tailed
operate: operating operated
well: better
wound: wounded
comb: combed
mycontribution: mycontributions
sever: severed
assign: assigned
estimate: estimated
communication: communications
clear: cleared
repeat: repeated
register: registered
donate: donating
forr: forrest
far: further
interdict: interdicting
installation: installations
marker: markers
land: landing
browse: browsing
conceive: conceived
convert: converted
store: stores
caction: cactions
follow: following followed
congest: congested
acuman: acumen
design: designed
near: neared
indicate: indicated
booksource: booksources
replenish: replenished
haul: hauling hauled
unanticipate: unanticipated
tactic: tactics
resourceloaderdynamicstyle: resourceloaderdynamicstyles
namespace: namespaces
move: moving
flatcar: flatcars
fast: faster
blame: blamed
countermeasure: countermeasures
defeat: defeated
indent: indenting
minefield: minefields
conduct: conducted
crater: craters
group: groups
survey: surveyed
secure: secured
chartre: chartres
child: children
stack: stacked
engineer: engineers
segregate: segregated
leave: leaving
generator: generators
arrive: arrived
increase: increased
earmark: earmarked
editorial: editorials
specialpage: specialpages
quantity: quantities
factor: factors
soar: soared
origin: origins
pin: pinned
mark: marked
system: systems
rename: renaming
damage: damaged
combine: combined
head: heading
eastward: eastwards
employ: employed
spare: spares
borrow: borrowed
load: loaded
organize: organized
movement: movements
matter: matters
occupy: occupied
purpose: purposes
anchorage: anchorages
futil: futils
sabotage: sabotaged
division: divisions
power: powered
facility: facilities
obstruct: obstructed
field: fields
divert: diverted
passenger: passengers
attempt: attempting attempted
dispute: disputes
construct: constructed constructing
edit: edited editing
civilian: civilians
regulate: regulating
start: started
ship: shipping shipped
journey: journeys
creativecommon: creativecommons
exist: exists
host: hosted
visit: visited
accident: accidents
equip: equipped
report: reported
great: greater
stripe: stripes
litter: littered
convoy: convoys
bathe: bathing
soldier: soldiers
scale: scales
offload: offloading
supplant: supplanted
breakdown: breakdowns
object: objects
characterize: characterized
reserve: reserves
restore: restored
persist: persisted
interval: intervals
imbue: imbuing
charle: charles
float: floated
improvement: improvements
burden: burdened
wheel: wheels
cease: ceased
unidentifie: unidentified
reinforce: reinforced
lack: lacked
month: months
describe: described
option: options
hedgerow: hedgerows
infantryman: infantrymen
marseille: marseilles
easy: easier
allocate: allocated
agree: agreed
locate: located
suit: suited
begin: beginning
conclude: concluded
punch: punched
activate: activated
convince: convincing
appoint: appointed
condition: conditions
column: columns
unpin: unpinned
portal: portals
depend: depended
entail: entailed
stretch: stretched
meet: meeting
basin: basins
trigger: triggered
represent: representing
marketeer: marketeers
container: containers
consolidate: consolidated
swap: swapped
render: rendering
retreat: retreating
developer: developers
decode: decoding
serve: served
engine: engines
realize: realized
commandeer: commandeered
opening: openings
inculcate: inculcated
flotilla: flotillas
concentrate: concentrated
push: pushed
sweep: sweeps
thousand: thousands
undesirable: undesirables
crowd: crowding
write: written
tip: tipped
image: images
refill: refilling
destroy: destroyed
prepare: prepared
bridge: bridges
coaster: coasters
renne: rennes
close: closed
ration: rationing
stock: stocks
accept: accepted
compel: compelled
resource: resources
