accord: according
change: changes
bfrlpub: bfrlpubs
claim: claimed claims
increase: increases
vapor: vapors
requirement: requirements
expand: expands expanded
level: levels
recentchangeslinke: recentchangeslinked
sheet: sheets
archive: archived
race: racing
period: periods
nitrite: nitrites
filter: filters
associate: associated
maintain: maintaining maintained
treatment: treatments
warm: warmer
lower: lowers
lead: leading
antifreeze: antifreezes
statistic: statistics
animal: animals
exclude: excludes
metal: metals
distil: distilled
revision: revisions
need: needed
cover: covers
measure: measures measuring
nowraplink: nowraplinks
antifriza: antifrizas
closedsystemcleane: closedsystemcleaning
farticle: farticles
contain: contains containing
boil: boiling
connect: connecting
form: formed
disclaimer: disclaimers
smoke: smoking
recognize: recognized
vehicle: vehicles
classaction: classactions
retrieve: retrieved
allow: allowing allows
ingest: ingesting
common: commons
antivrie: antivries
fluoresce: fluoresces
cold: colder
reference: references
dynamic: dynamics
wayne: waynes
select: selected selecting
language: languages
firstheade: firstheading
judge: judges
list: listed
currentevent: currentevents
provide: provided
shortcoming: shortcomings
subject: subjects
link: linked
surface: surfaces
publication: publications
motor: motors
lonwork: lonworks
brown: browning
exchanger: exchangers
high: highest higher
function: functioning
tolerate: tolerated
amount: amounts
davy: davies
weak: weaker
dilution: dilutions
unporte: unported
melt: melting
circulate: circulating
cache: cached
contaminant: contaminants
compress: compressed
sign: signed
alternative: alternatives
adjust: adjusting
langlink: langlinks
heater: heaters
freeze: freezing freezes
oxidize: oxidizes oxidized
indicator: indicators
catlink: catlinks
monitor: monitored monitoring
organism: organisms
dissolve: dissolved
emission: emissions
contribution: contributions
spring: springs
problem: problems
fclassaction: fclassactions
advantage: advantages
remove: removed
cause: causing caused causes
specialize: specialized
add: adding
hide: hidden
produce: produced
pump: pumping
plainlink: plainlinks
result: results resulting
package: packaged
place: places
action: actions
isomer: isomers
effect: effects
sentence: sentences
affect: affected
log: logged
datasheet: datasheets
introduce: introduced
improve: improved
develop: develops developed
generate: generating
determine: determines determined
dot: dotted
come: coming
state: states
method: methods
party: parties
bait: baited
replace: replaced
outgas: outgassing
indicate: indicates
crystal: crystals
communicate: communicating
service: services
radiator: radiators
consider: considered
market: marketed
burst: bursting
property: properties
cryoprotectant: cryoprotectants
hudgen: hudgens
pound: pounds
psychrometric: psychrometrics
gasket: gaskets
space: spaces spacing
acoustic: acoustics
content: contents
document: documents
expose: exposes
start: starts
parse: parsed
match: matches
inhibit: inhibiting inhibited
elsevi: elsevier
second: seconds
enable: enabled
category: categories
component: components
report: reporting
hazard: hazards
large: larger
organization: organizations
include: including includes
expect: expected
intend: intended
fish: fishes
dressing: dressings
present: presented
call: called
ounce: ounces
environment: environments
withstand: withstands
refill: refilled
contractor: contractors
particle: particles
variant: variants
stratify: stratified
recommendation: recommendations
entity: entities
license: licenses
cool: cooled cooler cooling
collapse: collapsed collapses
bear: bearing
commercialize: commercialized
dilute: diluted
failure: failures
tag: tagged
authority: authorities
chiller: chillers
turn: turning
profession: professions
solute: solutes
technology: technologies
assist: assisted
clean: cleaning
structure: structured
recentchange: recentchanges
long: longer
standard: standards
misconception: misconceptions
color: colored
lubricant: lubricants
announce: announced
dedicate: dedicated
protein: proteins
bowle: bowles
formula: formulas
agent: agents
concept: concepts
paper: papers
couple: coupled
mandate: mandated
gmdoc: gmdocs
encourage: encouraged
azole: azoles
vendor: vendors
burn: burning
control: controlled controls
electronic: electronics
fireproof: fireproofing
editor: editors
require: requiring
specify: specified
chill: chilled
knock: knocking
product: products
become: became
building: buildings
build: builds
complication: complications
dstandard: dstandards
depend: depending
robot: robots
event: events
recommend: recommended
dispel: dispelling
article: articles
alcohol: alcohols
fpublication: fpublications
appear: appears
thermodynamic: thermodynamics
guide: guides
relate: related
upload: uploads
coolant: coolants
bottle: bottles
unsource: unsourced
manufacturer: manufacturers
solution: solutions
sitelink: sitelinks
operate: operating operated
contaminate: contaminated
well: better
style: styles
mycontribution: mycontributions
otherproject: otherprojects
treat: treated
capacity: capacities
float: floating
address: addressed
register: registered
fill: filling
handle: handling
donate: donating
can: cannot
balance: balancing
browse: browsing
condition: conditioning
impurity: impurities
compound: compounds
convert: converted
complainant: complainants
caction: cactions
booksource: booksources
replenish: replenished
resourceloaderdynamicstyle: resourceloaderdynamicstyles
amine: amines
material: materials
namespace: namespaces
occur: occurs
particulate: particulates
rotate: rotating
engineer: engineers
post: posted
identifier: identifiers
specialpage: specialpages
additive: additives
pin: pinned
formulate: formulated
system: systems
damage: damaged
head: heading
employ: employed
temperature: temperatures
statement: statements
load: loaded
butylate: butylated
jury: juries
mixture: mixtures
reduce: reduces reduced
pressurize: pressurized
cigarette: cigarettes
reverse: reversing
application: applications
label: labeled
inhibitor: inhibitors
principle: principles
formulation: formulations
corrode: corroding
power: powered
human: humans
facility: facilities
illuminate: illuminated
ping: pinging
extend: extended
edit: edited editing
regulate: regulating
localize: localized
drain: drained
source: sources
creativecommon: creativecommons
exist: exists
host: hosted
visit: visited
citereffletcherhewdavie: citereffletcherhewdavies
wolflube: wolflubes
full: fuller
lawsuit: lawsuits
findarticle: findarticles
trade: trades
project: projects
enclose: enclosed
remain: remaining remains
plant: plants
fluid: fluids
buffer: buffers
improvement: improvements
condense: condensing
leak: leaked
force: forced
silicate: silicates
process: processed
option: options
fdocument: fdocuments
agree: agreed
library: libraries
borate: borates
charter: chartered
column: columns
unpin: unpinned
pocket: pockets
automobile: automobiles
trigger: triggered
test: tested
accumulate: accumulated
render: rendering
developer: developers
decode: decoding
strip: strips
substance: substances
engine: engines
climate: climates
point: points
strong: stronger
image: images
chemical: chemicals
close: closed
propose: proposed
foul: fouling
