specialpage: specialpages
change: changes
langlink: langlinks
pin: pinned
system: systems
indicator: indicators
head: heading
catlink: catlinks
expand: expanded
load: loaded
recentchangeslinke: recentchangeslinked
archive: archived
contribution: contributions
supply: supplies
fuel: fuelling
crossing: crossings
reduce: reduced
associate: associated
structure: structured
recentchange: recentchanges
long: longer
less: lesser
block: blocked
concern: concerned
hide: hidden
location: locations
flander: flanders
sailing: sailings
clear: clearing
power: powered
plainlink: plainlinks
require: required
facility: facilities
collapse: collapsed collapses
statistic: statistics
place: places
passenger: passengers
seaport: seaports
action: actions
revision: revisions
edit: edited editing
sentence: sentences
encourage: encouraged
operation: operations
need: needed
control: controls
log: logged
creativecommon: creativecommons
editor: editors
exist: exists
host: hosted
visit: visited
nowraplink: nowraplinks
army: armies
establish: established
contain: containing
broad: broadest
confirm: confirmed
company: companies
space: spacing
complication: complications
redirect: redirected
fisherman: fishermen
route: routes
robot: robots
disclaimer: disclaimers
understand: understanding
harbor: harbors
event: events
article: articles
ally: allied
retrieve: retrieved
retain: retained
guide: guides
tight: tighter
improvement: improvements
relate: related
ranking: rankings
cease: ceased
connection: connections
sitelink: sitelinks
common: commons
service: services
fluctuate: fluctuated
convention: conventions
consider: considered
option: options
sustain: sustained
harbour: harbours
reference: references
style: styles
mycontribution: mycontributions
operate: operating
promote: promoting
strike: strikes
language: languages
content: contents
firstheade: firstheading
register: registered
troop: troops
conduit: conduits
donate: donating
unpin: unpinned
parse: parsed
select: selected
employee: employees
country: countries
second: seconds
currentevent: currentevents
enable: enabled
provide: provided
category: categories
land: landing
busy: busiest
trigger: triggered
browse: browsing
link: linked linking
reopen: reopened
caction: cactions
publication: publications
render: rendering
blockade: blockades
developer: developers
decode: decoding
serve: served
demonstrate: demonstrated
booksource: booksources
high: highest
resourceloaderdynamicstyle: resourceloaderdynamicstyles
namespace: namespaces
point: points
reinforce: reinforcing
evacuate: evacuated
unporte: unported
variant: variants
image: images
disgruntle: disgruntled
entity: entities
license: licenses
undefende: undefended
ferry: ferries
engineer: engineers
face: facing
cache: cached
transmit: transmitted
