specialpage: specialpages
change: changes
langlink: langlinks
obtain: obtained
island: islands
pin: pinned
conversion: conversions
career: careers
indicator: indicators
proceeding: proceedings
head: heading
raider: raiders
catlink: catlinks
load: loaded
recentchangeslinke: recentchangeslinked
archive: archived
involve: involved
contribution: contributions
cornwalli: cornwallis
reduce: reduced
associate: associated
structure: structured
recentchange: recentchanges
remove: removed
bring: brought
develop: developed
block: blocked
hide: hidden
warship: warships
power: powered
vike: viking
collapse: collapsed collapses
ground: grounding
statistic: statistics
place: places
revision: revisions
edit: edited editing
convert: converting converted
cruiser: cruisers
sentence: sentences
encourage: encouraged
control: controls
log: logged
creativecommon: creativecommons
editor: editors
exist: exists
describe: describing
decker: deckers
fviking: fvikings
host: hosted
visit: visited
equip: equipped
vessel: vessels
report: reports
contain: containing
blockship: blockships
read: reading
complication: complications
fship: fships
robot: robots
disclaimer: disclaimers
project: projects
instal: installed
decommission: decommissioned
event: events
battery: batteries
constructor: constructors
article: articles
guardship: guardships
sail: sailing
remain: remaining remains
force: forces
retrieve: retrieved
guide: guides
defend: defending
improvement: improvements
relate: related
endure: enduring
sitelink: sitelinks
common: commons
speed: speeds
scuttle: scuttled
option: options
early: earlier
reference: references
mycontribution: mycontributions
apply: applied
otherproject: otherprojects
magazine: magazines
float: floating
language: languages
content: contents
firstheade: firstheading
viking: vikings
register: registered
donate: donating
publish: publishing
parse: parsed
far: further
select: selected
attack: attacking
second: seconds
currentevent: currentevents
enable: enabled
category: categories
trigger: triggered
browse: browsing
link: linked
caction: cactions
cut: cutting
render: rendering
developer: developers
decode: decoding
intend: intended
river: rivers
booksource: booksources
high: highest
commandeer: commandeered
tactic: tactics
resourceloaderdynamicstyle: resourceloaderdynamicstyles
namespace: namespaces
call: called
thame: thames
hasting: hastings
attempt: attempts
group: groups
unporte: unported
variant: variants
image: images
entity: entities
license: licenses
cache: cached
leave: leaving
fleet: fleets
