specialpage: specialpages
identifier: identifiers
change: changes
langlink: langlinks
pin: pinned
indicator: indicators
proceeding: proceedings
head: heading
pelante: pelanting
catlink: catlinks
wagon: wagons
expand: expanded
coupling: couplings
articulate: articulated
recentchangeslinke: recentchangeslinked
drolle: drolling
frolle: frolling
load: loaded
archive: archived
roll: rolling
contribution: contributions
race: racing
reduce: reduced
attraction: attractions
roadrail: roadrailer
associate: associated
railway: railways
structure: structured
recentchange: recentchanges
application: applications
specialize: specialized
hide: hidden
dine: dining
power: powered
plainlink: plainlinks
couple: coupling
collapse: collapsed collapses
business: businesses
statistic: statistics
place: places
coupler: couplers
tamp: tamping
revision: revisions
edit: edited editing
sentence: sentences
encourage: encouraged
operation: operations
ship: shipped
fbook: fbooks
control: controls
log: logged
wheel: wheeled
taxrate: taxrates
creativecommon: creativecommons
editor: editors
exist: exists
host: hosted
visit: visited
accident: accidents
roadway: roadways
nowraplink: nowraplinks
contain: containing
company: companies
building: buildings
space: spacing
complication: complications
refrigerate: refrigerated
robot: robots
disclaimer: disclaimers
project: projects
propel: propelled
unify: unified
enclose: enclosed
dot: dotted
event: events
article: articles
state: states
vehicle: vehicles
investment: investments
retrieve: retrieved
guide: guides
improvement: improvements
relate: related
respelle: respelling
matthia: matthias
sitelink: sitelinks
common: commons
consider: considered
include: including
option: options
refer: refers
reference: references
style: styles
carry: carrying
vestibule: vestibuled
fdocument: fdocuments
mycontribution: mycontributions
apply: applied
define: defined
otherproject: otherprojects
signal: signals
library: libraries
language: languages
content: contents
estimate: estimated
firstheade: firstheading
register: registered
document: documents
locomotive: locomotives
donate: donating
unpin: unpinned
portal: portals
parse: parsed
subsidy: subsidies
select: selected
country: countries
second: seconds
currentevent: currentevents
enable: enabled
category: categories
station: stations
michigan: michigans
trigger: triggered
fsale: fsales
taxform: taxforms
browse: browsing
arolle: arolling
container: containers
pack: packed
link: linked
caction: cactions
render: rendering
motorize: motorized
coach: coaches
developer: developers
decode: decoding
booksource: booksources
motorsport: motorsports
high: highest
sleep: sleeping
resourceloaderdynamicstyle: resourceloaderdynamicstyles
namespace: namespaces
hbill: hbills
train: trains
ftaxform: ftaxforms
flatcar: flatcars
connect: connected
topic: topics
follow: follows
contrast: contrasts
cover: covered
track: tracks
unporte: unported
variant: variants
image: images
entity: entities
license: licenses
travel: travelling
cache: cached
access: accessed
nopopup: nopopups
