accord: according
friend: friends
need: needed needing
adopt: adopted
pronounce: pronounced
requirement: requirements
recentchangeslinke: recentchangeslinked
archive: archives archived
involve: involved
promotion: promotions
emulate: emulated
fregistrar: fregistrars
master: masters
campaign: campaigns campaigned campaigning
seek: seeking sought
fasset: fassets
general: generals
border: bordered
andrew: andrews
recognize: recognized recognizing
speaker: speakers
brink: brinks
foffice: foffices
byrne: byrnes
preserve: preserved
nowraplink: nowraplinks
formalize: formalized
contain: containing
read: reading
ander: anders
controversy: controversies
induct: inducted
smoke: smoking
authorize: authorizing authorized
communist: communists
avoid: avoiding
unfold: unfolded
play: playing played
assassinate: assassinated
custom: customs
experience: experiences experienced experiencing
implication: implications
defend: defended
peacemaker: peacemakers
southerner: southerners
order: orders ordered
prisoner: prisoners
man: manning
opinion: opinions
learn: learning learned
dub: dubbed
reconvene: reconvened
fight: fought fighting
consist: consisted
usage: usages
language: languages
companion: companions
judge: judges
wikimediacommon: wikimediacommons
fighter: fighters
breaker: breakers
medal: medals
afrikaan: afrikaans
override: overriding
citerefcampbellconversemillerstoke: citerefcampbellconversemillerstokes
landscape: landscapes
movie: movies
constitution: constitutions
prevent: prevented
loss: losses
debate: debates
persuade: persuaded
deplore: deplored
whistleblower: whistleblowers
kill: killed killing
inflame: inflamed
transport: transported
study: studied studies
weak: weaker
high: highest higher
unporte: unported
degree: degrees
cache: cached
issue: issuing issued issues
reeve: reeves
langlink: langlinks
let: letting
relative: relatives
xiaope: xiaoping
sister: sisters
support: supported supporting
thwart: thwarted
belong: belonged
economic: economics
priority: priorities
subvert: subverting
bush: bushes
spring: springs
range: ranging
incident: incidents
suggest: suggesting suggested
rule: ruling
landing: landings
deem: deemed
add: adding
hide: hidden
sentiment: sentiments
location: locations
template: templates
clear: clearing
formulate: formulating formulated
found: founding founded
cadet: cadets
draft: drafted
secrete: secreting
precede: preceded
quote: quoted
affair: affairs
action: actions
last: lasting lasted
power: powers powered
falsify: falsified
log: logged
watkin: watkins
republican: republicans
strike: struck
prevail: prevailed prevails prevailing
army: armies
phase: phases
say: saying
brother: brothers
determine: determined
request: requested requests
conclude: concluding concluded
stake: staked
state: states stated stating
force: forced forces
victory: victories
service: services
disarm: disarmed
concern: concerned concerning concerns
veteran: veterans
samaritan: samaritans
policy: policies
settle: settling
migrate: migrated
fmovie: fmovies
reveal: revealed
end: ending
richard: richards
convict: convicted
fstage: fstaging
match: matches
encompass: encompassing
enable: enabled
category: categories
airfield: airfields
large: largest larger
remain: remains remained
intend: intending intended
express: expressed expressing
adhere: adhered
constitute: constituted
regard: regarded regarding
tribute: tributes
facilitate: facilitated
intimidate: intimidated
individual: individuals
flyover: flyovers
citerefgibb: citerefgibbs
direct: directed
speculate: speculated
dash: dashed
parent: parents
fairbank: fairbanks
battlefield: battlefields
entity: entities
interest: interests
threaten: threatening threatened
introduce: introducing introduced
peke: peking
result: results resulted resulting
reposition: repositioned
victim: victims
achieve: achieving achieved
decorate: decorated
look: looked
sign: signing signed
fcommittee: fcommittees
journal: journals
structure: structured
recentchange: recentchanges
long: longer
ambassador: ambassadors
finish: finished
standard: standards
stress: stressed
bring: bringing brought
stand: standing
fshadowpresident: fshadowpresidents
writer: writers
nytime: nytimes
evaluation: evaluations
cause: causing caused causes
uprising: uprisings
deliver: delivered
backstair: backstairs
disagreement: disagreements
school: schooling schools
member: members
table: tables
database: databases
sadden: saddened
discuss: discussed
crop: cropped
control: controlled controls
biography: biographies
short: shorter
servant: servants
fall: fallen
incorporate: incorporates incorporated
take: taking
require: required requiring
wyome: wyoming
roadway: roadways
brochure: brochures
scream: screaming
officer: officers
death: deaths
similarity: similarities
lag: lagging
robot: robots
skill: skills
relation: relations
planner: planners
fpublication: fpublications
artist: artists
network: networks
vorbi: vorbis
honor: honors honored
relate: related
upload: uploads
continue: continued
ranking: rankings
raise: raising raised
convention: conventions
slap: slapped slapping
include: including included includes
harden: hardened
operate: operated
rhode: rhodes
escort: escorted
assign: assigned
scholar: scholars
codec: codecs
resolve: resolved
subordinate: subordinates
forr: forrest
distinction: distinctions
charge: charged
letter: letters
navboxe: navboxes
punctuate: punctuated
impend: impending
underscore: underscored
overrule: overruled
material: materials
namespace: namespaces
thame: thames
occur: occurs
apply: applied applying
parachute: parachuting
claim: claimed claims claiming
secure: secured securing
record: recorded records
college: colleges
engineer: engineers
endorse: endorsed endorsing
winner: winners
specialpage: specialpages
hearing: hearings
fly: flying
island: islands
pin: pinned
farmer: farmers
discount: discounting
anglicize: anglicized
receive: received receiving
endanger: endangered
matter: matters
edmund: edmunds
instruction: instructions
governor: governors
catsimatidi: catsimatidis
cigarette: cigarettes
hoope: hoopes
new: newest
sense: sensed
dispatch: dispatched
portrait: portraits
circumstance: circumstances
prove: proved
contact: contacts
extend: extending extended
mint: minted
inject: injected
help: helped helping
offer: offers offered offering
pursue: pursued
hopkin: hopkins
jeyur: jeyurs
sweep: sweeping
tackle: tackled
work: worked working
equip: equipped
great: greatest greater
enterprise: enterprises
resident: residents
steep: steeped
album: albums
soldier: soldiers
admit: admitted
dial: dialed
provide: providing provided
wage: waging
pass: passed passing
improvement: improvements
present: presents presenting presented
fstorie: fstories
ship: shipping
describe: described
welcome: welcomed welcomes
classmate: classmates
establish: establishing established
meeting: meetings
undertake: undertook undertaken
activate: activated
commission: commissioned
believe: believing believed believes
thing: things
millionaire: millionaires
appear: appearing appeared
detail: detailed details
suspicion: suspicions
astronaut: astronauts
decode: decoding
serve: served serving
integrate: integrating integrated
discussion: discussions
complain: complaining complained
dever: devers
thousand: thousands
bar: barred
supervise: supervising supervised
denounce: denounced
westerner: westerners
proclamation: proclamations
sword: swords
resent: resented
renew: renewed
center: centered centers
story: stories
shock: shocked
btime: btimes
resource: resources
show: showed showing
german: germans
historian: historians
roll: rolled
redirect: redirects
expand: expanded
recruit: recruited recruits
thatch: thatched
list: listing listed
weaken: weakening weakened
place: placing places placed
schedule: scheduled
funeral: funerals
maintain: maintaining maintained
mislead: misled
trial: trials
escalate: escalating escalated
decide: decides decided
catch: caught
amputate: amputated
advisor: advisors
effort: efforts
award: awarding awarded awards
warlord: warlords
drop: dropping dropped
insist: insisted insisting
citerefyoungschille: citerefyoungschilling
revision: revisions
consequence: consequences
criterion: criteria
crack: cracks
operation: operations
call: calling called
fbook: fbooks
ask: asking
fclassroom: fclassrooms
farticle: farticles
accuse: accused
resume: resumed
refuse: refused refusing
condemn: condemning condemned
watch: watching
understand: understanding
note: noting
open: opened
politic: politics
retrieve: retrieved
profile: profiles
word: worded
ruin: ruined
danger: dangers
respelle: respelling
benefit: benefits
undergo: undergoes
soviet: soviets
republic: republics
vote: voting
compare: compared
resist: resisting
guest: guests
radio: radioed
occasion: occasions
firstheade: firstheading
protect: protected
acknowledge: acknowledged
cluster: clusters
select: selected selecting
currentevent: currentevents
stem: stemming
bolster: bolstered
strengthen: strengthening strengthened
link: linked
recover: recovered recovering
satellite: satellites
back: backed
counterpart: counterparts
camp: camped
advise: advising advised
motivation: motivations
embed: embedded
discharge: discharged
reverse: reversed
divide: divided
nopopup: nopopups
afflict: afflicted
halfback: halfbacks
collect: collected
prefer: preferred
singe: singing
weekend: weekends
enter: entered entering
aspect: aspects
get: getting
advantage: advantages
remove: removed
bail: bailed
contribute: contributed
plainlink: plainlinks
timeline: timelines
handle: handling handled
necessitate: necessitated
santo: santos
shadowpresident: shadowpresidents
sentence: sentences sentenced
affect: affected
hobby: hobbies
fail: failed failing
weapon: weapons
company: companies
oppose: opposing opposed
highway: highways
urging: urgings
student: students
quality: qualities
eagle: eagles
forteacher: forteachers
come: coming
ally: allied allies
party: parties
replace: replaced
spirit: spirits
fusnew: fusnews
painting: paintings
respect: respected
shortage: shortages
depart: departed
ratify: ratified
nation: nations
knight: knights
outnumber: outnumbering
fpolitic: fpolitics
warn: warned warning
lieutenant: lieutenants
pescadore: pescadores
drag: dragging
target: targets targeting
mystery: mysteries
crosse: crosses
program: programs
fifty: fifties
content: contents
advance: advanced
attitude: attitudes
gallstone: gallstones
relinquish: relinquished
graduate: graduates graduating graduated
critic: critics
djeyur: djeyurs
bombing: bombings
catalog: cataloged
organization: organizations
citerefkomon: citerefkomons
fbiographie: fbiographies
inhabit: inhabited
contract: contracts
tonic: tonics
mission: missions
ignore: ignored ignoring
fupload: fuploads
fcommercial: fcommercials
tuition: tuitions
flemme: flemming
legiswork: legisworks
designate: designated
explore: exploring
right: rights
reprimand: reprimanding
collapse: collapsed collapses
essay: essays
decision: decisions
complete: completed
ancestor: ancestors
atrocity: atrocities
turn: turned turning
relent: relented
latime: latimes
articulate: articulated
fwebe: fwebed
reactivate: reactivated
embrace: embracing
fimporte: fimported
retire: retired
confront: confronting confronted
invoke: invoking
dedicate: dedicated
struggle: struggles
concept: concepts
paper: papers
diminish: diminished
watershe: watershed
delay: delayed
create: created creating
carry: carried carrying
highlight: highlights highlighted
spot: spotted
deception: deceptions
redistricte: redistricting
summarize: summarized
paule: pauling
assume: assumed
publisher: publishers
official: officials
threat: threats
event: events
dissuade: dissuaded
guide: guided guides
notice: noticed
endure: endured enduring
manufacturer: manufacturers
unreserve: unreserved
transform: transformed
martin: martins
mccomb: mccombs
early: earlier
activity: activities
style: styles
nichola: nicholas
mycontribution: mycontributions
pilot: pilots
interject: interjected
give: giving
orient: oriented
realize: realizing
retain: retaining
disclose: disclosed
shape: shaped
fpresident: fpresidents
employee: employees
browse: browsing
chairman: chairmen
follow: following followed follows
launch: launching launched
write: written writing
visit: visiting visited visits
move: moving
unknown: unknowns
italian: italians
agreement: agreements
balk: balked
conduct: conducted
provision: provisions
witness: witnesses
disavow: disavowed
display: displayed
intervene: intervening
feisenhower: feisenhowers
businessman: businessmen
promote: promoting promoted
arrive: arrived
pose: posing
baptize: baptized
become: becoming became
system: systems
combine: combined
initiate: initiated
stray: strayed
employ: employed
attract: attracted
name: naming
synonym: synonyms
reinjure: reinjured
act: acting
monument: monuments
trustee: trustees
occupy: occupied
label: labeled
relish: relished
develop: developed developing
suffer: suffering suffered
executive: executives
crusade: crusades
civilian: civilians
institute: institutes
mesmerize: mesmerizing
rest: resting
wear: wearing
rename: renamed
confrontation: confrontations
host: hosted
sociale: sociales
encourage: encouraging encouraged
tyson: tysons
survive: survived
fresource: fresources
deny: denied denies
attribution: attributions
proposal: proposals
subtitle: subtitles
alliance: alliances
casualty: casualties
charle: charles
upgrade: upgraded
agree: agreed
library: libraries
locate: located
gloat: gloating
eulogize: eulogized
begin: beginning
appoint: appointed
feprint: feprints
column: columns
unpin: unpinned
sport: sports
deal: dealing
nominee: nominees
suspect: suspected
impoverish: impoverished
fcenter: fcenters
engine: engines
speech: speeches
usnew: usnews
rescue: rescued
inculcate: inculcated
accomplish: accomplishing accomplished
bonny: bonnier
archivesih: archivesihs
battle: battles
prepare: prepared
fleme: fleming
title: titles
person: persons
revert: reverted
remind: reminding
travel: traveled
reproduction: reproductions
shed: shedding
terrorist: terrorists
phrase: phrases
storkor: storkors
dull: dulles
ticket: tickets
hear: hearing
stockpile: stockpiles
puzzle: puzzled
seeker: seekers
associate: associated
nominate: nominating
send: sending
chequer: chequers
gain: gaining gained
argue: argued argues
lead: leading
bomb: bombed
politician: politicians
statistic: statistics
ffile: ffiles
justify: justified
perform: performed performing
speak: speaking speaks
presidency: presidencies
airplane: airplanes
document: documenting documents
family: families
challenge: challenging
measure: measures
ffinde: ffinding
commemorate: commemorating
doctor: doctors
concede: conceded
run: running
cumming: cummings
pershe: pershing
city: cities
disclaimer: disclaimers
purge: purges purging
instal: installed
novel: novels
forename: forenames
duty: duties
return: returned
investment: investments
disappointment: disappointments
orchestrate: orchestrated
hendrick: hendricks
reflect: reflected
common: commons
miniserie: miniseries
rotate: rotated
decade: decades
reference: references
average: averaged
criticize: criticized criticizes
cant: canting
administrator: administrators
implement: implemented
injure: injured
superior: superiors
desire: desired
drive: driving driven
initial: initials
confine: confines
identity: identities
citerefthompkin: citerefthompkins
live: living
tell: telling
demonstrate: demonstrated
close: closest
convince: convincing convinced
want: wanted wanting
think: thinking thought
press: pressed
induce: induced
house: houses
fdetail: fdetails
favor: favored
young: younger youngest
margin: margins
grandchild: grandchildren
alternative: alternatives
indicator: indicators
committee: committees
placement: placements
inspire: inspired
difficulty: difficulties
forgo: forgoing
worker: workers
reactor: reactors
contribution: contributions
execute: executed
allow: allowing allowed
commit: commits committed
postpone: postponed
approve: approved approving
recall: recalled
produce: produced
overwhelm: overwhelming
limit: limits
ukrainian: ukrainians
join: joined
entanglement: entanglements
bury: buried
enjoy: enjoyed
headquarter: headquartered
checker: checkers
programme: programmes
chore: chores
ground: grounds
russian: russians
participate: participated participating
grant: granted
stavridi: stavridis
improve: improved
instructor: instructors
dalla: dallas
lesson: lessons
outgo: outgoing
rutherfordbhaye: rutherfordbhayes
invite: invited inviting
commercial: commercials
office: offices
method: methods
dvait: dvaits
cook: cooking
minute: minutes
command: commanded commands commanding
philippine: philippines
try: trying
alienate: alienated
educate: educated
perceive: perceived
objective: objectives
mathia: mathias
citerefprevot: citerefprevots
inductee: inductees
have: having
plan: planned planning
remember: remembers
fforteacher: fforteachers
inauguration: inaugurations
invasion: invasions
reject: rejected
refugee: refugees
brooking: brookings
pledge: pledged
colour: coloured
parse: parsed
ftemplate: ftemplates
arkansa: arkansas
second: seconds
vacation: vacationing
urge: urging
photographer: photographers
stamp: stamps
fbushe: fbushes
position: positions
operative: operatives
declassify: declassified
appointment: appointments
dismiss: dismissed
focus: focused
corner: corners
frank: franks
hostility: hostilities
pick: picked
recommendation: recommendations
stop: stopped
inform: informed
influence: influenced
bear: bearing
check: checked
tender: tendered
fstudie: fstudies
signal: signaled
accelerate: accelerated
govern: governed
authority: authorities
faction: factions
approach: approached
activist: activists
anticipate: anticipated
demand: demanding demands demanded
investigation: investigations
alumnus: alumni
citerefwukovit: citerefwukovits
attach: attaches
change: changed changes changing
devote: devoted
strafe: strafing
eisenhower: eisenhowers
comment: comments
view: viewed
leader: leaders
product: products
devise: devised
ender: enders
disappear: disappeared
article: articles
reckon: reckoning
attack: attacks attacking
eprint: eprints
feel: feeling
crime: crimes
appearance: appearances
hondegree: hondegrees
otherproject: otherprojects
treat: treated
register: registered
far: further
remark: remarks
voter: voters
supporter: supporters
paint: painted
oilman: oilmen
caction: cactions
distinguish: distinguished
conversation: conversations
dictionary: dictionaries
coach: coaches
elect: elected
booksource: booksources
fbend: fbender
firing: firings
tactic: tactics
import: imported
fnation: fnations
resign: resigned
angel: angels
scientist: scientists
success: successes
tradition: traditions
balance: balanced
leave: leaving
reason: reasons
increase: increased
mark: marking marked
liberal: liberals
head: heading
borrow: borrowed
guardian: guardians
exile: exiles
dent: dented
newspaper: newspapers
confer: conferred
purpose: purposes
lay: laying
bresource: bresources
admire: admired
edit: edited editing
localize: localized
source: sources
wukovit: wukovits
publicroad: publicroads
exist: exists
report: reported reports
delegate: delegates
rely: relied
other: others
rkdartist: rkdartists
neighbor: neighboring neighbors
elaborate: elaborated
burial: burials
thompkin: thompkins
discourage: discouraged
respond: responded
lack: lacked
fyalebook: fyalebooks
option: options
applicant: applicants
fdocument: fdocuments
assault: assaults
classroom: classrooms
identify: identified
deepen: deepened
condition: conditions
publish: published publishing
surgeon: surgeons
meet: meeting
trigger: triggered
derive: derived
render: rendering
disenchant: disenchanted
developer: developers
citerefblackhopkin: citerefblackhopkins
donate: donating donated
keep: keeping
whine: whines
deploy: deployed
farchive: farchives
encounter: encountered
image: images
flash: flashes
academic: academics
bridge: bridges
ffact: ffacts
frighten: frightened
fellowship: fellowships
stabilize: stabilized
marine: marines
obtain: obtained
surround: surrounded
abandon: abandoned
fnewspaper: fnewspapers
champion: championed
memory: memories
brief: briefing
stall: stalled
televise: televised
agency: agencies
citerefjacob: citerefjacobs
embark: embarked
inaugurate: inaugurated
missile: missiles
rejoice: rejoicing
surrender: surrendered
fbrochure: fbrochures
ambition: ambitions
player: players
elevate: elevating
cancel: cancelled
make: making
stage: stages
engage: engaged
defeat: defeated defeats defeating
erupt: erupted
administration: administrations
vehicle: vehicles
government: governments
low: lowest
craft: crafts
hodge: hodges
find: finding
prompt: prompted
exhume: exhumed
design: designs designed
commander: commanders
troop: troops
medve: medved
expert: experts
independent: independents
opportunity: opportunities
symptom: symptoms
subject: subjects
soften: softened
publication: publications
primary: primaries
fspeeche: fspeeches
quotation: quotations
victor: victors
market: markets
regulation: regulations
miss: missing
restore: restoring
discover: discovered
strength: strengths
inspection: inspections
dislike: disliked
reduce: reducing reduced
catlink: catlinks
citizen: citizens
denote: denotes
ulysse: ulysses
define: defining
problem: problems
point: pointed
declare: declared
hille: hilles
diagnose: diagnosed
bizjournal: bizjournals
liberty: liberties
overarch: overarching
faward: fawards
diary: diaries
mathematic: mathematics
abuse: abuses
conference: conferences
response: responses
transcode: transcoded
boomer: boomers
espouse: espoused
pay: paying
microformat: microformats
consideration: considerations
dot: dotted
fpage: fpages
depth: depths
withdraw: withdrawing withdrawn
examine: examined
praise: praising praised
guideline: guidelines
break: broken
representative: representatives
consider: considered
bomber: bombers
succeed: succeeded
exception: exceptions
immerse: immersed
reexamine: reexamining
relationship: relationships
airandspaceforce: airandspaceforces
emphasize: emphasized
attend: attended
sander: sanders
switch: switched
ftradition: ftraditions
spark: sparked
prevot: prevots
choice: choices
shell: shelling
chairperson: chairpersons
candidate: candidates
deficit: deficits
old: oldest
variant: variants
election: elections
memoir: memoirs
license: licenses
rattler: rattlers
failure: failures
chief: chiefs
villain: villains
fsite: fsites
nickname: nicknamed
asset: assets
tension: tensions
assist: assisted
million: millions
justice: justices
announce: announced
promise: promised
account: accounts
earn: earning
conservative: conservatives
guess: guessing
citerefmedve: citerefmedved
editor: editors
grave: graves
prioritize: prioritized
exacerbate: exacerbated
schaep: schaeper
gymnastic: gymnastics
allegation: allegations
cite: citing
space: spacing
complication: complications
benne: benning
physician: physicians
reporter: reporters
marry: married
entrust: entrusted
bypass: bypassed
adkin: adkins
recommend: recommended
subpoena: subpoenas
personality: personalities
decoration: decorations
unsource: unsourced
sitelink: sitelinks
dispense: dispensing
fledgle: fledgling
senator: senators
transfer: transferred
logistic: logistics
roger: rogers
negotiation: negotiations
well: better
reach: reached
fmysterie: fmysteries
communication: communications
address: addressing addressed
kick: kicked
country: countries
land: landing
permit: permitted
assistant: assistants
bait: baiting
expend: expended
indicate: indicated
stuff: stuffed
resourceloaderdynamicstyle: resourceloaderdynamicstyles
hughe: hughes
blame: blamed
fund: funded
group: groups
dawkin: dawkins
depose: deposed
uninspire: uninspiring
child: children
haine: haines
fhighlight: fhighlights
post: posted
rival: rivals
identifier: identifiers
question: questions
inch: inches
fine: finest
mind: minded
exchange: exchanged
statement: statements
load: loaded
represent: represents
organize: organized
misdiagnose: misdiagnosed
chair: chairs
fpublicroad: fpublicroads
memorial: memorials
citerefjone: citerefjones
freport: freports
division: divisions
trap: trapped
choose: choosing
talent: talents
obstruct: obstructed
shoot: shooting
field: fields
construct: constructing
pave: paving
release: released
creativecommon: creativecommons
box: boxing
accident: accidents
night: nights
hold: holding
decline: declined
lesbian: lesbians
commitment: commitments
attempt: attempted
project: projects projected
entitle: entitled
characterize: characterized
plant: plants
persist: persisted
eizenhauer: eizenhauers
president: presidents
reclassify: reclassified
supply: supplied
month: months
opponent: opponents
consent: consented
curtail: curtailed
lang: langer
hunt: hunting
revolutionize: revolutionized
opine: opined
portal: portals
voice: voiced
maneuver: maneuvers
wish: wishes
accompany: accompanied
mohamme: mohammed
misplace: misplaced
test: tested
interact: interacted
train: trained
recipient: recipients
fangel: fangels
lose: losing
university: universities
flegiswork: flegisworks
conclusion: conclusions
athletic: athletics
arrange: arranged
allowance: allowances
ability: abilities
strong: stronger
destroy: destroyed
registrar: registrars
secret: secrets
acquaintance: acquaintances
station: stationed
propose: proposed
defense: defenses
accept: accepted
capture: captured
