specialpage: specialpages
change: changes
discover: discovered
langlink: langlinks
german: germans
pin: pinned
complete: completed
assault: assaulted
support: supporting
indicator: indicators
engagement: engagements
head: heading
catlink: catlinks
expand: expanded
recentchangeslinke: recentchangeslinked
load: loaded
contribution: contributions
earn: earned
reduce: reduced
mount: mounted
destroy: destroying destroyed
allow: allowed
torpedo: torpedoes
associate: associated
structure: structured
recentchange: recentchanges
expose: exposed
hide: hidden
conflict: conflicts
grab: grabbed
clear: clearing
power: powered
plainlink: plainlinks
lead: leading
collapse: collapsed collapses
statistic: statistics
place: placed places
refuse: refused
action: actions
revision: revisions
edit: edited editing
dislodge: dislodged
footnote: footnotes
close: closing
pillbox: pillboxes
sentence: sentences
encourage: encouraged
fbook: fbooks
siegfrie: siegfried
control: controls
log: logged
source: sources
creativecommon: creativecommons
flamethrower: flamethrowers
editor: editors
exist: exists
leader: leaders
employ: employing
host: hosted
visit: visited
equip: equipped
command: commanded
nowraplink: nowraplinks
contain: containing
cite: citing
space: spacing
complication: complications
fsiegfrie: fsiegfried
attempt: attempted
soldier: soldiers
robot: robots
disclaimer: disclaimers
propel: propelled
dot: dotted
event: events
article: articles
state: states
ally: allied
retrieve: retrieved
guide: guides
improvement: improvements
relate: related
continue: continued
charge: charges
sitelink: sitelinks
common: commons
service: services
receive: received
bunker: bunkers
param: params
logistic: logistics
option: options
regiment: regiments
correspond: corresponding
destroyer: destroyers
reference: references
lack: lacking
style: styles
wound: wounds wounded
mycontribution: mycontributions
fight: fighting
language: languages
content: contents
firstheade: firstheading
commander: commanders
register: registered
troop: troops
donate: donating
photo: photos
belligerent: belligerents
publish: publishing
unpin: unpinned
parse: parsed
match: matches
flank: flanking
select: selected
second: seconds
currentevent: currentevents
enable: enabled
category: categories
emplacement: emplacements
counterattack: counterattacks
trigger: triggered
browse: browsing
link: linked
include: includes
caction: cactions
detail: details
render: rendering
position: positions
encircle: encircling
developer: developers
decode: decoding
experience: experienced
high: highest
citation: citations
resourceloaderdynamicstyle: resourceloaderdynamicstyles
namespace: namespaces
error: errors
involve: involving
direct: directed
miss: missing
unporte: unported
variant: variants
image: images
battle: battles
entity: entities
license: licenses
cache: cached
coordinate: coordinates
introduce: introducing
