inhibit: inhibits inhibiting
specialpage: specialpages
change: changes
immerse: immersing
reynold: reynolds
barrier: barriers
beach: beaches
accelerate: accelerated
discover: discovered
langlink: langlinks
citerefreynold: citerefreynolds
swim: swimming
pin: pinned
inspection: inspections
community: communities
ensure: ensuring
indicator: indicators
damage: damaged
head: heading
trace: traces
detect: detected detecting
catlink: catlinks
history: histories
organism: organisms
recentchangeslinke: recentchangeslinked
load: loaded
burrow: burrows burrowing
dissolve: dissolved
contribution: contributions
mariner: mariners
can: canning
preserver: preservers
termite: termites
problem: problems
reduce: reduced
prevent: prevented prevents
conifer: conifers
associate: associated
structure: structures structured
recentchange: recentchanges
remove: removed
develop: developed
penetrate: penetrated
expose: exposed
avoid: avoided
hide: hidden
century: centuries
cause: causes
rot: rotting
fondation: fondations
exposure: exposures
power: powered
warm: warmer
require: required
stringer: stringers
helse: helsing
submerge: submerged
collapse: collapsed collapses
date: dating
statistic: statistics
vary: varied
place: places
deteriorate: deteriorating
study: studying
member: members
revision: revisions
edit: edited editing
inhabit: inhabiting
gribble: gribbles
sentence: sentences
crack: cracks
encourage: encouraged
lagoon: lagoons
control: controls
log: logged
challenge: challenging
creativecommon: creativecommons
editor: editors
section: sections
flood: flooding
exist: exists
tunnel: tunnels
know: knowing
host: hosted
visit: visited
term: termed
establish: established
shipworm: shipworms
contain: containing
wrap: wrapping
replace: replaced replacing
lakedwellingsof: lakedwellingsofs
differ: differs
stage: stages
read: reading
building: buildings
complication: complications
borer: borers
official: officials
robot: robots
disclaimer: disclaimers
fdutchdike: fdutchdikes
limit: limiting
ftfimage: ftfimages
create: creating
attach: attached
event: events
recommend: recommended
constructor: constructors
article: articles
state: states
method: methods
remain: remaining remains
dweller: dwellers
interval: intervals
retrieve: retrieved
sample: sampling
guide: guides
flakedwellingsof: flakedwellingsofs
attack: attacks attacked
dutchdike: dutchdikes
infest: infested
spirit: spirits
improvement: improvements
relate: related
sitelink: sitelinks
common: commons
assembly: assemblies
revive: revived
hawser: hawsers
reinforce: reinforced
describe: describes
fteredolite: fteredolites
supply: supplied
microbe: microbes
dwelling: dwellings
month: months
include: including included
option: options
impregnate: impregnated
reach: reaching
maintain: maintaining
reference: references
mycontribution: mycontributions
drought: droughts
apply: applied
siphon: siphons
inspect: inspecting
supplier: suppliers
rest: rested
locate: located
tfimage: tfimages
wharve: wharves
treat: treated
realize: realizing
language: languages
content: contents
firstheade: firstheading
register: registered
fill: filling
piling: pilings
advance: advanced
protect: protected
donate: donating
condition: conditions
publish: publishing
column: columns
pholad: pholads
unpin: unpinned
water: waters
parse: parsed
far: further
support: supported
select: selected
second: seconds
currentevent: currentevents
enable: enabled
hardwood: hardwoods
panel: panels
imprison: imprisoned
trigger: triggered
browse: browsing
chromate: chromated
diver: divers
link: linked
derive: derived
surface: surfaces
caction: cactions
cut: cutting
detail: details
evaluate: evaluated
render: rendering
developer: developers
decode: decoding
serve: served
foundation: foundations
insect: insects
booksource: booksources
experience: experienced
preservative: preservatives
high: highest
timber: timbers
resourceloaderdynamicstyle: resourceloaderdynamicstyles
extract: extracts
namespace: namespaces
call: called
bivalve: bivalves
degrade: degrades
look: looking
bore: boring
excavation: excavations
contractor: contractors
house: houses
cannery: canneries
fdetail: fdetails
beetle: beetles
group: groups
embed: embedded
unporte: unported
variant: variants
image: images
teredolite: teredolites
destroy: destroyed
entity: entities
pile: piling
license: licenses
builder: builders
chemical: chemicals
technique: techniques
cache: cached
inundate: inundated
leave: leaving
device: devices
