specialpage: specialpages
change: changes
langlink: langlinks
bridge: bridging
pin: pinned
tag: tagged
inactivate: inactivated inactivating
support: supporting
indicator: indicators
engagement: engagements
combine: combined
head: heading
province: provinces
statement: statements
catlink: catlinks
expand: expanded
recentchangeslinke: recentchangeslinked
load: loaded
archive: archived
credit: credited
contribution: contributions
reduce: reduced
enter: entered
reactivate: reactivated
associate: associated
structure: structured
recentchange: recentchanges
campaign: campaigns
airman: airmen
flineage: flineages
landing: landings
platoon: platoons
lineage: lineages
hide: hidden
location: locations
reorganize: reorganizing
reference: references referenced
clear: clearing
power: powered
facility: facilities
collapse: collapsed collapses
award: awarded
statistic: statistics
place: places
follow: following
action: actions
headquarter: headquartered
revision: revisions
edit: edited editing
sentence: sentences
encourage: encouraged
operation: operations
need: needed
control: controls
log: logged
source: sources
creativecommon: creativecommons
incorporate: incorporating incorporates
editor: editors
exist: exists
host: hosted
visit: visited
contain: containing
repair: repairing
engage: engaged
space: spacing
complication: complications
form: formed
soldier: soldiers
manassa: manassas
robot: robots
disclaimer: disclaimers
attach: attached
branch: branches
event: events
article: articles
state: states
ally: allied
force: forces
improvise: improvised
retrieve: retrieved
redesignate: redesignated
break: broken
guide: guides
honor: honors
improvement: improvements
relate: related
endure: enduring
unsource: unsourced
sitelink: sitelinks
common: commons
service: services
receive: received
battalion: battalions
month: months
unload: unloading
reflagge: reflagged
option: options
regiment: regiments
compose: composed
include: included
fspde: fspdes
mycontribution: mycontributions
assault: assaults
operate: operating
assign: assigned
language: languages
content: contents
firstheade: firstheading
activate: activated
register: registered
troop: troops
donate: donating
medal: medals
injure: injured
coordinate: coordinating
unpin: unpinned
parse: parsed
match: matches
select: selected
detach: detached
formation: formations
second: seconds
currentevent: currentevents
enable: enabled
accomplish: accomplished
category: categories
land: landing
trigger: triggered
browse: browsing
link: linked
partner: partnering
caction: cactions
render: rendering
developer: developers
decode: decoding
remain: remained
serve: served
color: colors
participate: participated
focus: focused
mission: missions
high: highest
citation: citations
resourceloaderdynamicstyle: resourceloaderdynamicstyles
namespace: namespaces
deploy: deployed
redeploy: redeployed
falcon: falcons
designation: designations
kill: killed
designate: designated
conduct: conducted
unporte: unported
variant: variants
image: images
entity: entities
license: licenses
engineer: engineers
cache: cached
element: elements
